{
  "grid": [
  [1,1,1,1,1,1,1,1,1,1,1,1],
  [1,1,1,1,1,1,1,1,1,1,0,1],
  [1,0,0,0,0,0,0,0,0,1,0,1],
  [1,0,1,1,1,1,1,1,0,1,0,1],
  [1,0,1,0,0,0,0,1,0,1,0,1],
  [1,0,1,0,1,1,0,1,0,1,0,1],
  [1,0,1,0,1,0,0,1,0,1,0,1],
  [1,0,1,0,1,1,1,1,0,1,0,1],
  [1,0,1,0,0,0,0,0,0,1,0,1],
  [1,0,1,1,1,1,1,1,1,1,0,1],
  [1,0,0,0,0,0,0,0,0,0,0,1],
  [1,1,1,1,1,1,1,1,1,1,1,1]
  ],
  "player": {"x":5,"y":6,"dir":2},
  "goal": {"x":10,"y":1},
  "max_blocks": 10
}