{
  "grid": [
  [1,0,1,1,1,1,1,1],
  [1,0,1,0,0,0,0,1],
  [1,0,1,0,1,1,0,1],
  [1,0,1,0,1,1,0,1],
  [1,0,1,0,0,1,0,1],
  [1,0,1,1,1,1,0,1],
  [1,0,0,0,0,0,0,1],
  [1,1,1,1,1,1,1,1]
  ],
  "player": {"x":1,"y":0,"dir":2},
  "goal": {"x":4,"y":4},
  "max_blocks": 20
}