{
  "grid": [
  [1,1,1,1,1,1,1,1,1],
  [1,0,1,0,0,0,1,0,1],
  [1,0,1,0,1,0,1,0,1],
  [1,0,1,0,1,0,1,0,1],
  [1,0,1,0,1,0,1,0,1],
  [1,0,1,0,1,0,1,0,1],
  [1,0,1,0,1,0,1,0,1],
  [1,0,0,0,1,0,0,0,1],
  [1,1,1,1,1,1,1,1,1]
  ],
  "player": {"x":1,"y":1,"dir":2},
  "goal": {"x":7,"y":1},
  "max_blocks": 13
}